....######.
...@.......
#########..
#######....
....###....
##........#
###......##
####......#
#####......
######....#
#######....