........###
###....####
###..@.....
##....###..
......####.
...#####...
....####...
..#########
...........
####.......
####.......